it,start,end,latency,sol,period
1,0,77772,77772,1,51550
2,11563,129322,117759,1,51550
3,21788,181219,159431,1,51654
4,32479,230896,198417,1,51060
5,42605,280439,237834,1,50605
6,52862,329832,276970,1,50241
7,63002,379306,316304,1,50011
8,73522,428743,355221,1,49839
9,83695,478046,394351,1,49678
10,118898,527534,408636,1,49621
11,170708,576895,406187,1,49543
12,220503,627326,406823,1,49809
13,270057,677018,406961,1,49774
14,319457,726841,407384,1,49788
15,368910,776970,408060,1,49890
16,418366,826661,408295,1,49830
17,467694,876033,408339,1,49693
18,517125,925359,408234,1,49583
19,566518,975103,408585,1,49631
20,616959,1024715,407756,1,49625
21,666629,1074101,407472,1,49553
22,716558,1123530,406972,1,49516
23,766596,1172951,406355,1,49487
24,816280,1223237,406957,1,49727
25,865676,1273112,407436,1,49771
26,915010,1322886,407876,1,49772
27,964685,1372945,408260,1,49858
28,1014333,1422603,408270,1,49798
29,1063754,1471923,408169,1,49654
30,1113165,1521342,408177,1,49584
31,1162587,1570750,408163,1,49531
32,1212878,1620222,407344,1,49513
33,1262703,1669576,406873,1,49465
34,1312550,1718922,406372,1,49429
35,1362560,1768458,405898,1,49461
36,1412224,1818655,406431,1,49682
37,1461593,1868254,406661,1,49657
38,1510957,1917880,406923,1,49647
39,1560384,1967940,407556,1,49771
40,1609830,2017745,407915,1,49781
41,1659197,2067196,407999,1,49682
42,1708621,2116714,408093,1,49633
43,1758134,2166105,407971,1,49560
44,1808188,2215491,407303,1,49508
45,1857846,2264932,407086,1,49487
46,1907557,2314310,406753,1,49454
47,1957575,2363746,406171,1,49449
48,2007457,2413718,406261,1,49606
49,2056890,2463552,406662,1,49674
50,2106301,2512823,406522,1,49553
51,2155696,2562338,406642,1,49541
52,2205093,2611759,406666,1,49505
53,2254522,2661110,406588,1,49459
54,2303962,2710448,406486,1,49422
55,2353365,2759907,406542,1,49433
56,2403206,2809284,406078,1,49416
57,2453175,2858734,405559,1,49426
58,2502493,2908236,405743,1,49449
59,2551914,2957595,405681,1,49422
60,2601397,3007138,405741,1,49458
61,2650724,3057139,406415,1,49621
62,2700080,3106799,406719,1,49632
63,2749480,3156733,407253,1,49723
64,2798939,3206619,407680,1,49772
65,2848422,3256078,407656,1,49678
66,2897829,3305367,407538,1,49561
67,2947211,3354880,407669,1,49546
68,2996626,3404219,407593,1,49484
69,3046689,3453621,406932,1,49459
70,3096394,3503094,406700,1,49463
71,3146343,3552416,406073,1,49421
72,3196264,3601843,405579,1,49422
73,3245659,3652223,406564,1,49710
74,3295028,3701578,406550,1,49603
75,3344440,3750828,406388,1,49497
76,3393879,3800391,406512,1,49517
77,3443288,3849831,406543,1,49493
78,3492690,3899247,406557,1,49470
79,3541993,3949043,407050,1,49568
80,3591418,4000619,409201,1,50170
81,3641828,4050064,408236,1,49952
82,3691208,4099697,408489,1,49856
83,3740554,4149130,408576,1,49729
84,3789970,4198598,408628,1,49651
85,3839387,4249034,409647,1,49886
86,3888904,4298360,409456,1,49718
87,3938692,4348379,409687,1,49808
88,3990250,4398389,408139,1,49869
89,4039710,4447824,408114,1,49738
90,4089356,4497321,407965,1,49666
91,4138718,4546611,407893,1,49553
92,4188233,4596110,407877,1,49537
93,4238591,4645469,406878,1,49483
94,4288026,4694884,406858,1,49463
95,4338003,4744276,406273,1,49441
96,4388075,4793659,405584,1,49424
97,4437507,4844037,406530,1,49710
98,4486884,4893505,406621,1,49637
99,4536272,4943490,407218,1,49741
100,4585706,4993505,407799,1,49823
101,4635097,5044452,409355,1,50160
102,4684526,5095162,410636,1,50325
103,4733886,5146036,412150,1,50490
104,4783316,5196844,413528,1,50585
105,4833654,5247068,413414,1,50477
106,4883105,5297511,414406,1,50466
107,4933141,5347628,414487,1,50361
108,4983121,5397914,414793,1,50339
109,5033899,5448938,415039,1,50544
110,5084729,5498875,414146,1,50362
111,5499698,5599156,99458,2,65337
112,5520167,5650779,130612,2,61223
113,5541108,5700190,159082,2,57679
114,5561821,5751149,189328,2,55663
115,5582554,5802094,219540,2,54247
116,5603275,5852832,249557,2,53194
117,5623925,5903802,279877,2,52527
118,5644680,5954849,310169,2,52083
119,5679340,6005835,326495,2,51754
120,5730244,6057621,327377,2,51763
121,5781199,6108405,327206,2,51469
122,5832102,6159786,327684,2,51443
123,5882995,6210974,327979,2,51366
124,5934037,6261848,327811,2,51218
125,5984939,6312668,327729,2,51099
126,6036771,6363545,326774,2,51032
127,6087659,6414485,326826,2,51004
128,6138922,6465420,326498,2,50983
129,6190157,6516321,326164,2,50958
130,6241033,6567130,326097,2,50913
131,6291904,6618171,326267,2,50952
132,6342787,6669229,326442,2,50983
133,6393671,6720042,326371,2,50932
134,6444544,6770956,326412,2,50927
135,6495399,6821779,326380,2,50895
136,6546288,6872752,326464,2,50918
137,6597192,6923503,326311,2,50868
138,6648383,6974399,326016,2,50876
139,6699266,7025244,325978,2,50867
140,6750118,7076210,326092,2,50896
141,6800990,7126992,326002,2,50862
142,6851859,7177941,326082,2,50888
143,6902718,7228933,326215,2,50919
144,6953577,7280012,326435,2,50967
145,7004476,7330904,326428,2,50944
146,7055332,7381789,326457,2,50926
147,7106233,7432649,326416,2,50906
148,7157120,7483475,326355,2,50882
149,7208034,7534367,326333,2,50885
150,7259166,7585341,326175,2,50911
151,7310020,7636100,326080,2,50866
152,7360954,7687002,326048,2,50876
153,7411812,7737841,326029,2,50865
154,7462694,7788816,326122,2,50898
155,7513581,7840221,326640,2,51050
156,7564478,7891166,326688,2,51018
157,7615348,7942134,326786,2,51003
158,7666203,7993088,326885,2,50988
159,7717065,8043925,326860,2,50943
160,7767979,8094882,326903,2,50947
161,7819393,8145784,326391,2,50933
162,7870377,8196675,326298,2,50920
163,7921239,8247629,326390,2,50930
164,7972211,8298568,326357,2,50933
165,8023125,8349425,326300,2,50910
166,8074115,8400363,326248,2,50918
167,8125011,8451883,326872,2,51099
168,8175908,8502708,326800,2,51016
169,8226815,8553558,326743,2,50966
170,8277690,8604537,326847,2,50970
171,8328577,8655442,326865,2,50950
172,8379501,8706369,326868,2,50943
173,8431050,8757110,326060,2,50882
174,8481906,8808139,326233,2,50926
175,8532770,8859031,326261,2,50916
176,8583725,8909879,326154,2,50895
177,8634622,8960729,326107,2,50882
178,8685498,9011779,326281,2,50932
179,8736385,9062929,326544,2,50997
180,8787279,9113952,326673,2,51005
181,8838221,9164751,326530,2,50943
182,8889085,9215697,326612,2,50944
183,8939946,9266547,326601,2,50915
184,8990844,9317402,326558,2,50897
185,9042147,9368362,326215,2,50916
186,9093090,9419323,326233,2,50929
187,9143967,9470216,326249,2,50918
188,9194848,9521045,326197,2,50891
189,9245761,9571823,326062,2,50857
190,9296617,9622771,326154,2,50884
191,9347511,9673954,326443,2,50974
192,9398428,9724839,326411,2,50947
193,9449303,9775625,326322,2,50899
194,9500206,9826679,326473,2,50945
195,9551061,9877488,326427,2,50904
196,9601899,9928335,326436,2,50887
197,9653143,9979478,326335,2,50964
198,9704034,10030471,326437,2,50972
199,9754919,10082239,327320,2,51211
200,9805819,10151957,346138,2,56763
201,9856723,10203381,346658,2,55161
202,9907683,10253244,345561,2,53571
203,9958657,10304677,346020,2,52930
204,10009656,10355737,346081,2,52369
205,10061443,10406264,344821,2,51816
206,10407258,10527617,120359,3,72677
207,10438159,10603772,165613,3,73720
208,10469427,10659725,190298,3,68390
209,10527627,10728754,201127,3,68581
210,10574013,10810758,236745,3,72608
211,10622779,10848802,226023,3,62239
212,10656034,10929626,273592,3,67814
213,10689347,10998564,309217,3,68151
214,10722644,11058862,336218,3,65795
215,10753900,11112681,358781,3,62202
216,10787175,11199482,412307,3,69582
217,10846397,11272920,426523,3,70738
218,10903257,11307075,403818,3,59763
219,10968060,11394437,426377,3,68043
220,11033041,11448307,415266,3,63791
221,11118368,11493411,375043,3,58185
222,11173249,11538524,365275,3,54263
223,11248163,11620756,372593,3,62654
224,11311923,11670439,358516,3,58762
225,11396936,11718437,321501,3,55533
226,11428126,11780460,352334,3,57480
227,11467567,11838652,371085,3,57693
228,11544139,11872101,327962,3,50420
229,11594298,11970899,376601,3,64933
230,11644099,12015570,371471,3,58854
231,11698043,12092707,394664,3,64339
232,11764481,12126459,361978,3,55163
233,11836019,12197699,361680,3,59986
234,11867283,12285791,418508,3,68417
235,11946042,12350180,404138,3,67209
236,12006190,12397104,390914,3,61123
237,12095411,12430346,334935,3,52759
238,12151936,12512708,360772,3,61640
239,12183101,12608299,425198,3,71825
240,12259871,12639507,379636,3,59640
241,12321150,12675748,354598,3,52620
242,12352351,12758178,405827,3,61563
243,12434635,12806142,371507,3,57483
244,12486299,12861079,374780,3,56719
245,12568716,12935039,366323,3,61891
246,12604490,12966228,361738,3,52680
247,12681245,13026893,345648,3,55076
248,12731724,13070775,339051,3,51717
249,12783596,13142637,359041,3,57761
250,12835447,13199705,364258,3,57553
251,12912700,13246857,334157,3,54432
252,12970943,13277945,307002,3,47429
253,13043064,13349620,306556,3,54703
254,13106274,13419113,312839,3,59140
255,13172753,13480415,307662,3,59788
256,13237022,13531479,294457,3,57171
257,13289040,13562740,273700,3,49398
258,13351517,13604608,253091,3,47139
259,13384741,13655042,270301,3,48127
260,13417910,13709990,292080,3,50173
261,13449014,13795447,346433,3,60758
262,13482178,13862884,380706,3,62762
263,13553830,13898086,344256,3,54494
264,13609779,13984514,374735,3,64074
265,13652749,14035165,382416,3,60047
266,13699680,14112319,412639,3,65179
267,13779892,14156166,376274,3,58779
268,13833611,14242438,408827,3,67027
269,13897697,14307349,409652,3,66392
270,13958178,14395707,437529,3,72982
271,14040075,14449087,409012,3,67101
272,14091924,14490301,398377,3,59335
273,14143672,14546357,402685,3,58351
274,14215984,14577495,361511,3,50187
275,14294664,14643514,348850,3,54936
276,14384244,14697115,312871,3,54536
277,14451769,14735467,283698,3,49680
278,14504909,14809430,304521,3,56965
279,14536084,14853459,317375,3,53084
280,14567310,14899332,332022,3,50921
281,14617289,14963203,345914,3,54806
282,14671030,15007082,336052,3,51527
283,14740646,15070937,330291,3,55226
284,14818400,15114818,296418,3,51822
285,14860901,15171024,310123,3,53137
286,14906173,15254343,348170,3,62192
287,14942726,15318298,375572,3,62720
288,15012574,15382925,370351,3,63292
289,15050438,15444201,393763,3,62687
290,15120205,15505406,385201,3,62242
291,15171034,15573756,402722,3,64075
292,15267101,15638643,371542,3,64318
293,15330430,15671903,341473,3,55001
294,15390507,15702938,312431,3,47811
295,15453961,15761803,307842,3,51127
296,15517349,15828295,310946,3,55736
297,15550703,15902259,351556,3,61204
298,15583902,15984661,400759,3,67564
299,15615055,16034003,418948,3,62097
300,15674755,16097480,422725,3,62511
301,15765167,16139136,373969,3,56254
302,15817988,16192705,374717,3,55448
303,15905698,16266373,360675,3,60914
304,15958162,16332410,374248,3,62451
305,16033716,16363552,329836,3,53058
306,16074962,16434436,359474,3,58406
307,16144052,16486282,342230,3,56438
308,16197465,16547436,349971,3,57852
309,16274051,16611317,337266,3,59661
310,16327913,16681284,353371,3,62753
311,16369027,16716834,347807,3,54592
312,16408692,16799709,391017,3,63076
313,16464956,16863834,398878,3,63391
314,16543383,16895006,351623,3,53725
315,16607396,16977185,369789,3,62261
316,16655006,17037555,382549,3,61694
317,16706483,17119713,413230,3,67833
318,16773310,17200593,427283,3,71747
319,16834986,17231876,396890,3,59608
320,16897030,17285306,388276,3,57754
321,16950961,17326593,375632,3,52814
322,17043005,17387983,344978,3,55387
323,17093426,17444422,350996,3,55702
324,17173594,17525091,351497,3,63192
325,17229902,17577360,347458,3,59915
326,17264769,17630695,365926,3,57941
327,17332155,17681995,349840,3,55948
328,17367682,17713244,345562,3,48538
329,17418843,17752943,334100,3,45886
330,17480489,17818363,337874,3,51746
331,17527390,17873949,346559,3,52898
332,17585688,17956369,370681,3,61755
333,17654961,18015584,360623,3,60993
334,17711015,18100562,389547,3,68188
335,17742195,18156714,414519,3,64577
336,17823692,18219952,396260,3,64175
337,17879524,18251063,371539,3,54256
338,17930045,18282231,352186,3,47329
339,18015596,18350092,334496,3,53489
340,18093032,18387650,294618,3,48709
341,18156404,18457264,300860,3,54981
342,18187684,18494751,307067,3,49732
343,18220955,18564217,343262,3,55652
344,18278196,18615610,337414,3,54374
345,18323581,18705456,381875,3,65016
346,18387334,18752941,365607,3,59756
347,18430823,18841545,410722,3,68410
348,18494419,18892873,398454,3,63286
349,18537931,18923988,386057,3,53634
350,18604929,18996807,391878,3,59390
351,18694987,19038968,343981,3,54221
352,18736283,19096552,360269,3,55230
353,18805391,19150422,345031,3,54822
354,18866780,19202202,335422,3,53909
355,18923998,19268228,344230,3,57544
356,18999307,19342273,342966,3,62494
357,19049422,19401948,352526,3,61648
358,19088944,19474147,385203,3,64813
359,19129901,19526517,396616,3,61080
360,19202215,19590269,388054,3,61882
361,19270889,19625670,354781,3,53937
362,19334373,19658897,324524,3,47724
363,19399477,19710251,310774,3,48813
364,19462810,19760892,298082,3,49361
365,19535246,19810385,275139,3,49401
366,19590454,19878341,287887,3,54967
367,19654058,19947925,293867,3,59352
368,19687325,19989171,301846,3,53920
369,19720515,20042005,321490,3,53594
370,19751621,20091674,340053,3,52416
371,19784857,20155676,370819,3,55892
372,19861981,20225562,363581,3,60090
373,19938149,20272677,334528,3,56197
374,19991266,20303795,312529,3,48673
375,20043768,20353562,309794,3,49001
376,20354435,20451805,97370,2,63774
377,20374964,20509606,134642,2,61982
378,20395918,20559016,163098,2,58210
379,20416606,20610299,193693,2,56132
380,20439396,20661619,222223,2,54688
381,20460113,20712612,252499,2,53579
382,20480721,20763510,282789,2,52775
383,20501550,20814396,312846,2,52208
384,20538167,20865344,327177,2,51830
385,20589490,20916239,326749,2,51549
386,20640828,20967137,326309,2,51354
387,20691723,21018115,326392,2,51241
388,20742625,21069096,326471,2,51163
389,20793655,21120006,326351,2,51087
390,20844555,21170920,326365,2,51035
391,20895454,21221879,326425,2,51012
392,20946365,21273093,326728,2,51072
393,20997268,21324022,326754,2,51029
394,21048213,21374846,326633,2,50968
395,21099171,21425877,326706,2,50986
396,21150109,21476728,326619,2,50946
397,21201010,21527718,326708,2,50959
398,21252244,21578567,326323,2,50926
399,21303164,21629434,326270,2,50908
400,21354091,21680497,326406,2,50954
401,21404964,21731437,326473,2,50950
402,21455892,21782335,326443,2,50934
403,21506792,21833144,326352,2,50896
404,21557705,21884254,326549,2,50960
405,21608679,21935094,326415,2,50924
406,21659601,21986092,326491,2,50946
407,21710529,22037100,326571,2,50965
408,21761457,22088055,326598,2,50962
409,21812417,22138944,326527,2,50940
410,21863420,22189830,326410,2,50923
411,21914330,22240739,326409,2,50919
412,21965255,22291722,326467,2,50938
413,22016191,22342682,326491,2,50944
414,22067143,22393542,326399,2,50919
415,22118072,22444928,326856,2,51059
416,22169030,22495802,326772,2,51003
417,22219966,22546719,326753,2,50977
418,22270888,22597668,326780,2,50969
419,22321755,22648470,326715,2,50918
420,22372713,22699468,326755,2,50942
421,22424068,22750323,326255,2,50916
422,22475007,22801402,326395,2,50965
423,22525894,22852422,326528,2,50981
424,22576878,22903215,326337,2,50925
425,22627740,22954148,326408,2,50927
426,22678637,23005181,326544,2,50959
427,22729526,23056739,327213,2,51138
428,22780616,23107656,327040,2,51072
429,22831555,23159033,327478,2,51163
430,22882470,23210227,327757,2,51172
431,22933399,23261227,327828,2,51120
432,22984325,23312054,327729,2,51032
433,23035894,23362960,327066,2,50994
434,23086869,23413920,327051,2,50984
435,23138133,23464827,326694,2,50961
436,23189379,23515713,326334,2,50938
437,23240291,23566528,326237,2,50901
438,23291206,23617440,326234,2,50904
439,23342129,23668766,326637,2,51031
440,23393103,23719674,326571,2,50994
441,23444018,23770476,326458,2,50936
442,23494928,23821510,326582,2,50965
443,23545791,23872334,326543,2,50923
444,23596734,23923385,326651,2,50961
445,23647945,23974151,326206,2,50902
446,23698839,24025065,326226,2,50906
447,23749751,24076180,326429,2,50968
448,23800662,24127146,326484,2,50967
449,23851574,24178035,326461,2,50944
450,23902488,24228957,326469,2,50937
451,23953395,24280103,326708,2,51000
452,24004293,24330998,326705,2,50968
453,24055319,24381913,326594,2,50952
454,24106312,24433064,326752,2,51012
455,24157214,24483791,326577,2,50926
456,24208110,24534741,326631,2,50933
457,24259258,24585575,326317,2,50903
458,24310174,24636580,326406,2,50934
459,24361076,24687465,326389,2,50919
460,24412125,24738294,326169,2,50892
461,24463039,24789484,326445,2,50981
462,24513901,24840652,326751,2,51037
463,24564832,24891668,326836,2,51031
464,24615775,24942450,326675,2,50956
465,24666661,24993452,326791,2,50970
466,24717564,25045173,327609,2,51195
467,24768632,25098739,330107,2,51906
468,24819789,25150605,330816,2,51894
469,24870812,25200327,329515,2,51242
470,24921715,25251756,330041,2,51298
471,24972700,25303242,330542,2,51354
472,25024358,25353863,329505,2,51134
473,25354514,25431143,76629,1,58978
474,25364410,25482572,118162,1,56713
475,25375074,25533339,158265,1,54929
476,25385895,25584223,198328,1,53715
477,25396185,25633686,237501,1,52440
478,25406454,25682932,276478,1,51481
479,25416761,25732362,315601,1,50866
480,25427082,25781781,354699,1,50432
481,25437562,25831142,393580,1,50110
482,25472203,25880650,408447,1,49929
483,25522986,25930382,407396,1,49870
484,25573828,25979698,405870,1,49704
485,25623275,26029541,406266,1,49745
486,25672673,26079216,406543,1,49724
487,25721978,26128553,406575,1,49608
488,25771402,26177934,406532,1,49540
489,25820824,26227194,406370,1,49456
490,25870230,26276573,406343,1,49432
491,25920015,26325946,405931,1,49414
492,25969358,26375175,405817,1,49359
493,26018921,26424458,405537,1,49336
494,26068888,26473846,404958,1,49351
495,26118198,26523168,404970,1,49342
496,26167540,26572588,405048,1,49366
497,26216887,26622231,405344,1,49449
498,26266196,26672089,405893,1,49571
499,26315535,26721429,405894,1,49502
500,26364877,26770776,405899,1,49455
501,26414156,26820246,406090,1,49459
502,26463495,26869584,406089,1,49423
503,26512810,26918939,406129,1,49402
504,26562117,26968197,406080,1,49359
505,26611701,27017562,405861,1,49361
506,26661724,27066882,405158,1,49348
507,26711019,27116360,405341,1,49387
508,26760398,27165832,405434,1,49412
509,26809857,27215080,405223,1,49363
510,26859196,27265360,406164,1,49638
511,26908538,27314730,406192,1,49557
512,26957838,27364010,406172,1,49474
513,27007161,27413438,406277,1,49460
514,27056534,27462749,406215,1,49415
515,27105993,27512097,406104,1,49395
516,27155366,27561412,406046,1,49371
517,27204766,27610718,405952,1,49351
518,27254992,27660180,405188,1,49384
519,27304384,27709447,405063,1,49349
520,27353720,27758715,404995,1,49325
521,27403084,27808190,405106,1,49370
522,27452401,27858518,406117,1,49657
523,27501697,27908146,406449,1,49648
524,27551007,27958100,407093,1,49740
525,27600403,28007946,407543,1,49771
526,27649747,28057384,407637,1,49671
527,27699084,28106909,407825,1,49627
528,27748452,28156302,407850,1,49557
529,27797847,28205643,407796,1,49492
530,27848115,28255029,406914,1,49460
531,27897714,28304335,406621,1,49414
532,27947693,28353678,405985,1,49392
533,27997559,28402987,405428,1,49367
534,28046958,28453196,406238,1,49620
535,28096590,28502503,405913,1,49526
536,28145898,28551716,405818,1,49432
537,28195284,28601163,405879,1,49436
538,28244621,28650492,405871,1,49404
539,28293931,28699802,405871,1,49376
540,28343271,28749177,405906,1,49375
541,28392645,28798742,406097,1,49432
542,28442739,28848092,405353,1,49407
543,28492129,28897422,405293,1,49384
544,28541442,28946655,405213,1,49339
545,28590775,28996194,405419,1,49399
546,28640125,29046351,406226,1,49626
547,28689466,29095747,406281,1,49557
548,28738792,29145782,406990,1,49700
549,28788353,29195828,407475,1,49804
550,28837694,29245108,407414,1,49646
551,28887004,29294478,407474,1,49563
552,28936348,29343732,407384,1,49470
553,28985757,29393103,407346,1,49440
554,29035975,29442701,406726,1,49488
555,29085451,29491978,406527,1,49424
556,29135425,29541352,405927,1,49409
557,29185447,29590708,405261,1,49393
558,29234713,29640800,406087,1,49603
559,29284072,29690292,406220,1,49569
560,29333413,29740298,406885,1,49700
561,29382724,29790345,407621,1,49804
562,29432294,29839649,407355,1,49654
563,29481610,29889139,407529,1,49605
564,29530944,29938822,407878,1,49628
565,29580307,29988202,407895,1,49553
566,29630394,30037502,407108,1,49477
567,29679960,30087105,407145,1,49515
568,29729935,30136382,406447,1,49443
569,29780011,30185693,405682,1,49403
570,29829331,30235292,405961,1,49462
571,29878704,30284988,406284,1,49532
572,29928458,30334418,405960,1,49501
573,29977768,30383595,405827,1,49404
574,30027106,30432994,405888,1,49402
575,30076715,30482327,405612,1,49381
576,30125994,30531621,405627,1,49355
577,30175331,30581004,405673,1,49363
578,30224780,30630303,405523,1,49344
579,30274656,30679715,405059,1,49364
580,30324028,30728970,404942,1,49331
581,30373344,30778439,405095,1,49372
582,30422613,30827884,405271,1,49394
583,30471955,30877704,405749,1,49522
584,30521266,30927045,405779,1,49467
585,30570625,30976339,405714,1,49415
586,30620011,31025631,405620,1,49378
587,30669322,31075113,405791,1,49409
588,30718634,31124425,405791,1,49380
589,30768094,31173789,405695,1,49375
590,30817450,31223153,405703,1,49371
591,30867283,31272468,405185,1,49354
592,30916629,31321788,405159,1,49344
593,30965911,31371134,405223,1,49344
594,31015306,31420423,405117,1,49328
595,31064709,31469722,405013,1,49319
596,31114001,31519016,405015,1,49311
597,31163346,31568412,405066,1,49337
598,31212748,31617731,404983,1,49331
599,31262059,31666977,404918,1,49305
600,31311397,31716299,404902,1,49310
601,31360739,31765761,405022,1,49356
602,31410034,31815121,405087,1,49357
603,31459372,31864454,405082,1,49350
604,31508674,31914164,405490,1,49458
605,31557988,31963524,405536,1,49428
606,31607349,32012930,405581,1,49421
607,31656722,32062327,405605,1,49414
608,31706016,32111866,405850,1,49451
609,31755323,32161230,405907,1,49425
610,31804754,32210667,405913,1,49428
611,31854006,32259927,405921,1,49378
612,31903775,32309349,405574,1,49391
613,31953115,32358585,405470,1,49344
614,32002518,32408004,405486,1,49367
615,32051950,32457307,405357,1,49347
616,32101533,32506639,405106,1,49343
617,32150872,32555941,405069,1,49330
618,32200298,32605395,405097,1,49367
619,32249612,32654728,405116,1,49357
620,32298923,32704124,405201,1,49368
621,32348281,32753376,405095,1,49333
622,32397591,32802886,405295,1,49386
623,32446905,32852236,405331,1,49375
624,32496249,32901517,405268,1,49347
625,32545589,32950889,405300,1,49354
626,32594974,33000286,405312,1,49367
627,32644349,33049642,405293,1,49363
628,32693687,33099042,405355,1,49374
629,32742999,33148417,405418,1,49374
630,32792479,33197623,405144,1,49324
631,32841817,33246945,405128,1,49323
632,32891133,33296305,405172,1,49334
633,32940489,33345542,405053,1,49305
634,32989870,33394866,404996,1,49310
635,33039203,33444229,405026,1,49326
636,33088668,33493621,404953,1,49346
637,33137976,33542890,404914,1,49323
638,33187314,33592330,405016,1,49358
639,33236624,33641583,404959,1,49326
640,33285900,33690895,404995,1,49322
641,33335217,33740215,404998,1,49321
642,33384583,33789585,405002,1,49336
643,33433865,33839002,405137,1,49360
644,33483212,33888228,405016,1,49320
645,33532571,33937620,405049,1,49341
646,33581901,33987000,405099,1,49353
647,33631225,34036344,405119,1,49350
648,33680541,34085708,405167,1,49354
649,33729817,34134943,405126,1,49318
650,33779211,34184298,405087,1,49329
651,33828596,34233609,405013,1,49323
652,33877908,34282904,404996,1,49315
653,33927217,34332293,405076,1,49337
654,33976590,34381697,405107,1,49357
655,34025900,34431236,405336,1,49411
656,34075286,34480606,405320,1,49399
657,34124620,34529828,405208,1,49346
658,34173928,34579256,405328,1,49370
659,34223239,34628583,405344,1,49357
660,34272553,34677835,405282,1,49325
661,34321863,34727134,405271,1,49317
662,34371232,34776180,404948,1,49236
663,34420855,34825089,404234,1,49138
664,34470166,34874027,403861,1,49078
665,34519483,34923064,403581,1,49065
666,34568809,34972022,403213,1,49033
667,34618204,35020889,402685,1,48983
668,34667487,35069541,402054,1,48884
